111111111111
1P0000000001
101110001111
1T0010T00101
111011000101
1000000T0001
111110000001
10001T000001
1GT000000001
111111111111