111111111111
1P0000000001
101110001111
1T00000000G1
111111111111